2 13 31
# # # # # # # # # # # # # # # # # # # # # # # # # # # # # # #
# p - - - - - * * - * - - 1 - * - 2 - * - - * - * - * - - - #
# - # - - # - # - # # # # * # - - # - - # - # * # * # * # - #
# - # - - # - # - # - - - - # - - # 1 - - - * - 2 - * - * - #
# - # # # # - # - # # # # - # - - # - * # - # - # - # - # * #
# f # - - # - # - # - - - - # - - # - - * - - - 1 - - - - - #
# - # - - # - # - # # # # - - # # - - * # - # * # - # - # - #
# s - - * - - - - - - * - - * - - - - - - * - - - - - - - - #
# - # - # - f - # * # - # - # - # * # * # - # - # - # - # - #
# * - - - - * * - - * - - - x - - - * - - - - - - - - - - - #
# - # * # - # - # - # - # - # - # * # - # - # - # - # - # - #
# - - - - - - - - - - - * - - - * - - * - - - - - - - - - - #
# # # # # # # # # # # # # # # # # # # # # # # # # # # # # # #